1-й Андріївський провулок	Богунський район
1-й Винокурний провулок	Богунський район
1-й Винокурний провулок	Богунський район
1-й Вільський провулок	Богунський район
1-й Госпітальний провулок	Корольовський район
1-й Житній провулок	Корольовський район
1-й Каракульний провулок	Богунський район
1-й Київський провулок	Корольовський район
1-й Корольова провулок	Корольовський район
1-й Кривий Брід провулок	Корольовський район
1-й Льва Толстого провулок	Корольовський район
1-й Льва Толстого провулок	Корольовський район
1-й Мисливський провулок	Корольовський район
1-й Павліковський провулок	Богунський район
1-й Паровозний провулок	Корольовський район
1-й Польової площі проїзд	Корольовський район
1-й Рівний провулок	Богунський район
1-й Сінний провулок	Богунський район
1-й Транзитний провулок	Корольовський район
1-й Фруктовий провулок	Корольовський район
1-й Іподромний провулок	Богунський район
1-й Іподромний провулок	Богунський район
2-й Льва Толстого провулок	Корольовський район
2-й Госпитальный провулок	Корольовський район
2-й Житний провулок	Корольовський район
2-й Кривой провулок	Богунський район
2-й Курганный провулок	Богунський район
2-й Охотничий провулок	Корольовський район
2-й Полевой провулок	Корольовський район
2-й Польовий провулок	Корольовський район
2-й Руднянский провулок	Богунський район
2-й Селецкий провулок	Корольовський район
2-й Сенный провулок	Богунський район
2-й Сінний провулок	Богунський район
2-й Чудновский провулок	Богунський район
2-й Шевченківський провулок	Корольовський район
23	Богунський район
3-й Березовский провулок	Богунський район
3-й Госпитальный провулок	Корольовський район
3-й Госпітальний провулок	Корольовський район
3-й Селецкий провулок	Корольовський район
3-й Смолянский провулок	Корольовський район
3-й Транзитный провулок	Корольовський район
3-й Чуднівський провулок	Корольовський район
3-й Шевченковский провулок	Корольовський район
4-й Вільський провулок	Богунський район
4-й Каракульний провулок	Богунський район
4-й Селецкий провулок	Корольовський район
4-й Чудновский провулок	Корольовський район
6-й Полевой провулок	Корольовський район
Авіаторів вулиця	Корольовський район
Академіка Тутковського проїзд	Корольовський район
Академіка Тутковського проїзд	Корольовський район
Андріївська вулиця	Богунський район
Барашевська вулиця	Богунський район
Басейна вулиця	Богунський район
Бердичівське шосе	
Береговий провулок	Корольовський район
Березовська вулиця	Богунський район
Богдана Хмельницького вулиця	Богунський район
Боковий провулок	Корольовський район
Болгарська вулиця	Богунський район
Бориса Лятошинского вулиця	Корольовський район
Бориса Лятошинського вулиця	Корольовський район
Бориса Тена вулиця	Корольовський район
Бруховского проїзд	Богунський район
Будівельний провулок	Богунський район
Бялика вулиця	Богунський район
Бяліка вулиця	Богунський район
Бічний провулок	Корольовський район
Василия Максютова вулиця	Богунський район
Ватутіна вулиця	Богунський район
Вацковський провулок	Корольовський район
Вацлава Длоуги вулиця	Богунський район
Велика Бердичівська вулиця	Корольовський район
Визволення майдан	Богунський район
Вильский Путь вулиця	Богунський район
Вокзальна вулиця	Корольовський район
Вокзальний провулок	Корольовський район
Володимирська вулиця	Богунський район
Володимирівська вулиця	Богунський район
Вячеслава Мали вулиця	Богунський район
Вільський Шлях вулиця	Богунський район
Вінницька вулиця	Корольовський район
Вітрука вулиця	Корольовський район
В’ячеслава Чорновола вулиця	Корольовський район
Гагаріна вулиця	Корольовський район
Генерала Всеволода Петрова вулиця	Богунський район
Генерала Всеволода Петріва вулиця	Богунський район
Героев Базара вулиця	Богунський район
Героев Десантников вулиця	Богунський район
Героев Пожарных вулиця	Богунський район
Героїв Базару вулиця	Богунський район
Героїв Десантників вулиця	Богунський район
Героїв Крут вулиця	Корольовський район
Героїв Пожежних вулиця	Богунський район
Героїв Чорнобиля вулиця	Богунський район
Гетмана Самойловича вулиця	Богунський район
Гетьмана Самойловича вулиця	Богунський район
Гоголя вулиця	Корольовський район
Гоголівська вулиця	Корольовський район
Гоголівська вулиця	Корольовський район
Гранитная вулиця	Богунський район
Деревообделочный провулок	Богунський район
Дмитра Донцова вулиця	Корольовський район
Дмитрівська вулиця	Корольовський район
Дмитрівська вулиця	Корольовський район
Добровольчих батальйонів вулиця	Корольовський район
Добровольчих батальйонів вулиця	Корольовський район
Довженка вулиця	Корольовський район
Домбровского вулиця	Богунський район
Домбровського вулиця	Богунський район
Енергетичний провулок	Корольовський район
Житний базар вулиця	Корольовський район
Житний рынок площа	Корольовський район
Житній Ринок вулиця	Корольовський район
Житній Ринок площа	Корольовський район
Жуйка вулиця	Корольовський район
Жуйко вулиця	Корольовський район
Заводська вулиця	Корольовський район
Закам’янська вулиця	Богунський район
Замкова площа	Богунський район
Зарембского площа	Богунський район
Зарічна вулиця	Корольовський район
Західна вулиця	Богунський район
Зв'язківців вулиця	Богунський район
Звягельская вулиця	Богунський район
Звільнення площа	Богунський район
Згоди майдан	Богунський район
Зелена вулиця	Богунський район
Ивана Слёты вулиця	Корольовський район
им. С.П. Королёва площа	Корольовський район
Кавалерийский провулок	Богунський район
Каменный Спуск провулок	Богунський район
Каракульна вулиця	Богунський район
Каракульная вулиця	Богунський район
Каретний провулок	Богунський район
Кафедральна вулиця	Богунський район
Кибальчича вулиця	Корольовський район
Київська вулиця	Богунський район
Київське шосе	Корольовський район
Князів Острозьких вулиця	Корольовський район
Князів Острозьських вулиця	Богунський район
Козацька вулиця	Богунський район
Комерційна вулиця	Корольовський район
Кооперативна вулиця	Корольовський район
Корабельна вулиця	Богунський район
Короленка вулиця	Богунський район
Короленка майдан	Богунський район
Короленка площа	Богунський район
Корольова вулиця	Корольовський район
Корольова майдан	Корольовський район
Коростишівська вулиця	Корольовський район
Коростышевская вулиця	Корольовський район
Косачів провулок	Богунський район
Космонавтів вулиця	Корольовський район
Коцюбинського вулиця	Корольовський район
Крилова провулок	Корольовський район
Крошенская вулиця	Богунський район
Крошенська вулиця	Богунський район
Крутий провулок	Корольовський район
Леонида Ступницкого провулок	Богунський район
Лермонтовська вулиця	Корольовський район
Лесі Українки вулиця	Богунський район
Леха Качинского вулиця	Богунський район
Леха Качинського вулиця	Корольовський район
Лугинский провулок	Богунський район
Луговой провулок	Богунський район
Лук’яненка вулиця	Корольовський район
Луцкий проїзд	Богунський район
Льва Толстого вулиця	Корольовський район
Львовский провулок	Богунський район
Львівська вулиця	Богунський район
Льонкова вулиця	Корольовський район
Любарська вулиця	Корольовський район
Лёнковая вулиця	Корольовський район
Лётчика Крутеня провулок	Корольовський район
Лісова вулиця	Богунський район
Мала Бердичівська вулиця	Корольовський район
Маликова вулиця	Богунський район
Малинова вулиця	Корольовський район
Малинська вулиця	Богунський район
Малинська вулиця	Богунський район
Марії Заньковецької провулок	Корольовський район
Металістів вулиця	Корольовський район
Метеорологический провулок	Богунський район
Миколи Лисенка вулиця	Корольовський район
Миру вулиця	Богунський район
Миру проспект	Богунський район
Михаила Кудрицкого провулок	Корольовський район
Михайла Грушевського вулиця	Богунський район
Михайлівська вулиця	Корольовський район
Млинна вулиця	Богунський район
Монтана вулиця	Богунський район
Московський проспект	Індустріальний район
Музичний провулок	Корольовський район
Набережна вулиця	Богунський район
Нагорный провулок	Богунський район
Народицкая вулиця	Богунський район
Народицька вулиця	Богунський район
Небесної Сотні вулиця	Богунський район
Незалежності проспект	Богунський район
Николая Сциборского вулиця	Богунський район
Нова вулиця	Богунський район
Новий бульвар	Корольовський район
Новогоголевская вулиця	Корольовський район
Новопівнічна вулиця	Богунський район
Новосенная вулиця	Богунський район
Новый бульвар	Корольовський район
Обувной провулок	Богунський район
Олександра Клосовського вулиця	Богунський район
Олександра Клоссовського вулиця	Богунський район
Ольжича вулиця	Богунський район
Ольжича вулиця	Богунський район
Отаманів Соколовських вулиця	Богунський район
Отаманів Соколовських вулиця	Богунський район
Офіцерська вулиця	Богунський район
Охримовая Гора вулиця	Богунський район
Павла Сингаевского вулиця	Корольовський район
Паперовий провулок	Корольовський район
Паперовий провулок	Корольовський район
Парковий провулок	Богунський район
Перемоги вулиця	Богунський район
Перемоги майдан	Богунський район
Перемоги площа	Богунський район
Першого Травня вулиця	Корольовський район
Пивоваренный провулок	Богунський район
Пляжна алея	Богунський район
Под Скалами набережна	Богунський район
Покровська вулиця	Богунський район
Польова площа	Корольовський район
Польовий майдан	Корольовський район
Польський бульвар	Богунський район
Польський бульвар	Богунський район
Політехнічний провулок	Богунський район
Привокзальна площа	Корольовський район
Промислова вулиця	Корольовський район
Професора Арциховського проїзд	Корольовський район
Профессора Арциховского проїзд	Корольовський район
Профессора Кравченко вулиця	Корольовський район
Прудний провулок	Богунський район
Прудный провулок	
Путятинская площа	Корольовський район
Путятинский провулок	Корольовський район
Путятинський майдан	Корольовський район
Пушкінська вулиця	Корольовський район
Південна вулиця	Корольовський район
Радивиловская вулиця	Богунський район
Радивілівська вулиця	Богунський район
Радоновая вулиця	Богунський район
Рильського вулиця	Богунський район
Рильського вулиця	Богунський район
Робоча вулиця	Корольовський район
Ровный провулок	Богунський район
Романа Шухевича вулиця	Богунський район
Садова вулиця	Богунський район
Садовий провулок	Богунський район
Саенко вулиця	Корольовський район
Санаторна вулиця	Богунський район
Свитынская вулиця	Корольовський район
Свободи вулиця	Богунський район
Святого Иоанна Павла II вулиця	Богунський район
Святого Йоана Павла ІІ вулиця	Богунський район
Святослава Ріхтера вулиця	Корольовський район
Святослава Ріхтера вулиця	Корольовський район
Северина Наливайка вулиця	Богунський район
Селецкая вулиця	Корольовський район
Сергія Параджанова вулиця	Корольовський район
Синельниківська вулиця	Корольовський район
Скорульского проїзд	Корольовський район
Скорульського проїзд	Корольовський район
Скульптора Олишкевича вулиця	Богунський район
Слобідська вулиця	Корольовський район
Смолянская площа	Корольовський район
Соборна площа	Корольовський район
Соборний майдан	Богунський район
Согласия площа	Богунський район
Сотника Савінського провулок	Богунський район
Станишовская площа	Корольовський район
Станишівський майдан	Корольовський район
Старий бульвар	Корольовський район
Старовильская вулиця	Богунський район
Старовільська вулиця	Богунський район
Стародавняя вулиця	Богунський район
Старочудновская вулиця	Богунський район
Старочуднівська вулиця	Богунський район
Старый бульвар	Корольовський район
Степана Бандери вулиця	Богунський район
Студентський провулок	Корольовський район
Східна вулиця	Богунський район
Танкистів вулиця	Богунський район
Танкістів вулиця	Богунський район
Тараса Бульби-Боровця вулиця	Богунський район
Тараса Бульбы-Боровца вулиця	Богунський район
Творческие Врата площа	Корольовський район
Театральна вулиця	Корольовський район
Телефонний провулок	Корольовський район
Телефонный провулок	Корольовський район
Тепличний провулок	Богунський район
Типографский провулок	Богунський район
Товарно-Грузовой провулок	Богунський район
Транспортна вулиця	Богунський район
Трипільська вулиця	Богунський район
Трояновская вулиця	Богунський район
Трояновский провулок	Богунський район
Троянівська вулиця	Богунський район
Успенський провулок	Богунський район
Учбовий провулок	Богунський район
Фещенка-Чопівського вулиця	Корольовський район
Фещенко-Чоповского вулиця	Корольовський район
Фруктова вулиця	Корольовський район
Фізкультурна вулиця	Богунський район
Хлібна вулиця	Богунський район
Холодильний проїзд	Корольовський район
Цюрупы вулиця	
Ціолковського вулиця	Корольовський район
Червоний провулок	Богунський район
Червоного Хреста вулиця	Корольовський район
Черняховский провулок	Богунський район
Черняхівський провулок	Богунський район
Чехова вулиця	Богунський район
Чорновола вулиця	Корольовський район
Чудновская вулиця	Богунський район
Чудновское шосе	Богунський район
Чуднівська вулиця	Богунський район
Чуднівське шосе	Богунський район
Шевченка вулиця	Корольовський район
Шкільна провулок	Корольовський район
Шодуаровский провулок	Корольовський район
Шолом-Алейхема вулиця	Богунський район
Шпаковский проїзд	Богунський район
Шпаковська вулиця	Богунський район
Юрка Тютюнника вулиця	Богунський район
Юрія Кондратюка проїзд	Корольовський район
Якова Зайко вулиця	Корольовський район
Євгена Коновальця вулиця	Богунський район
Євгена Рихліка вулиця	Богунський район
Івана Богуна проїзд	Богунський район
Івана Гонти вулиця	Корольовський район
Івана Кочерги вулиця	Корольовський район
Івана Кочерги вулиця	Корольовський район
Івана Мазепи вулиця	Корольовський район
Івана Огієнка вулиця	Корольовський район
Івана Сльоти вулиця	Корольовський район
Івана Сірка вулиця	Богунський район
Івана Франка вулиця	Корольовський район
Івана Франко вулиця	Корольовський район
Індустріальна вулиця	Богунський район